-------A------------
------AAA-----------
--AAAAAAAAAAA-------
-----A---A----------
------AAA-----------
-------A------------
------AAA-----------
-----A-A-A----------
----A--A--A---------
---A---A---A--------
------A-A-----------
-----A---A----------
----A-----A---------
--AA-------AA-------
--------------------
